##############****##############
#***********##****##***********#
#******************************#
#******************************#
#******************************#
#******************************#
#******************************#
#******************************#
#******************************#
#******************************#
#******************************#
#******************************#
#******************************#
#******************************#
#******************************#
#******************************#
#******************************#
#******************************#
#******************************#
#******************************#
#******************************#
#******************************#
#************##****##**********#
###############****#############